########## ########
#........###..h.p.##############
#..@.....|.|..bp..|...R........#
#........###.s.h..############.################
##############|####          #.|....S.........#
             #.#             #.##############.#
             #.#             #.#            #.#
             #.#             #.#            #.#
             #.#             #.#            #.#
             #.#             #.#            #.#
##############|###############|##############|#############
#.........................................................#
#.........................................................#
#.........................................................#
#....................R........................R...........#
#........d...........S....................................#
#.........................................................#
#.........................................................#
#.........................................................#
#.........................................................#
#.........................................................#
###########################################################