##################            #####################
#................##############...............B...#
#.....u..........|............|.........B.........#
#................##############...............B...#
##################            #####################