########## ########
#........###......##############
#..@.....|.|......|............#
#........###......############.################
##############|####          #.|..............#
             #.#             #.##############.#
             #.#             #.#            #.#
             #.#             #.#            #.#
             #.#             #.#            #.#
             #.#             #.#            #.#
##############|###############|##############|#############
#.........................................................#
#.........................................................#
#.........................................................#
#.........................................................#
#........d................................................#
#.........................................................#
#.........................................................#
#.........................................................#
#.........................................................#
#.........................................................#
###########################################################