##################            #####################
#................##############...................#
#.....u..........|............|...................#
#................##############...................#
##################            #####################