##################
#................#
#.....u..........#
#................#
##################