########## ########
#........###......##############
#...@....|.|......|............#
#........###......############.################
##############|####          #.|..............#
             #.#             #.##############.#
             #.#             #.#            #.#
             #.#             #.#            #.#
             #.#             #.#            #.#
             #.#             #.#            #.#
##############|###############|##############|#############
#.........................................................#
#.........................................................#
#................................R........................#
#.........................................................#
#........d...........S....................................#
#........u................................................#
#.........................................................#
#.........................................................#
#.........................................................#
#.........................................................#
###########################################################