########## ########
#........###......##############
#........|.|......|............#
#........###......############.################
##############|####          #.|..............#
             #.#             #.##############.#
             #.#             #.#            #.#
             #.#             #.#            #.#
             #.#             #.#            #.#
             #.#             #.#            #.#
##############|###############|##############|#############
#.........................................................#
#.........................................................#
#...@............................R........................#
#.........................................................#
#........d...........S....................................#
#.........................................................#
#.........................................................#
#.........................................................#
#.........................................................#
#.........................................................#
###########################################################