########## ########
#........###......##############
#..@.....|.|......|...R........#
#........###......############.################
##############|####          #.|....S.........#
             #.#             #.##############.#
             #.#             #.#            #.#
             #.#             #.#            #.#
             #.#             #.#            #.#
             #.#             #.#            #.#
##############|###############|##############|#############
#.........................................................#
#.........................................................#
#.........................................................#
#....................R........................R...........#
#........d...........S....................................#
#.........................................................#
#.........................................................#
#.........................................................#
#.........................................................#
#.........................................................#
###########################################################