###################
#........###......#
#..P.....|.|......#
#........###......#
##############|####
             #.#
             #.#
             #.#
             #.#
             #.#
##############|############################
#.........................................#
#.........................................#
#.........................................#
#.........................................#
#.........................................#
#.........................................#
###########################################